# # # # # #
# O . # . #
# # . # . #
# . # . . #
# # # # # #