# # # # # # # # # # # # # # # # # # # # # # # # # # # # # # #
# O . # . . # . . . . . # . . # . . . . . . . . # . . # . . #
# . . # . . # . . # # # # . . # . . # . . # # # # . . # . . #
# . . # . . # . . . . . . . . . . . # . . . . . # . . . . . #
# . . # . . # # # # . . # # # # . . # # # # . . # # # # . . #
# . . # . . . . . . . . # . . . . . . . . # . . . . . . . . #
# . . # # # # . . # . . # . . # # # # # # # . . # # # # . . #
# . . . . . . . . # . . # . . # . . # . . . . . # . . # . . #
# . . # # # # # # # . . # # # # . . # . . # . . # . . # . . #
# . . # . . . . . # . . # . . # . . # . . # . . # . . # . . #
# # # # # # # . . # # # # . . # . . # . . # . . # . . # # # #
# . . # . . # . . . . . . . . . . . . . . # . . . . . . . . #
# . . # . . # . . # # # # # # # . . # . . # . . # # # # . . #
# . . . . . . . . # . . . . . . . . # . . # . . . . . # . . #
# # # # . . # # # # # # # # # # # # # # # # . . # . . # # # #
# . . # . . # . . . . . # . . . . . . . . # . . # . . # . . #
# . . # . . # . . # # # # # # # . . # . . # # # # . . # . . #
# . . # . . . . . # . . # . . # . . # . . # . . # . . # . . #
# . . # . . # . . # . . # . . # . . # # # # . . # # # # . . #
# . . . . . # . . . . . . . . . . . . . . . . . . . . . . . #
# # # # # # # # # # # # # # # # # # # # # # # # # # # # # # #