# # # # # # # # # # # # # # # # # # # # # # # # # # # # # # #
# . . . . . # . . . . . . . # . # . . . . . # . . . . . . . #
# . # . # . # . # # # . # . # . # . # # # . # # # . # # # # #
# . # . # . # . . . # . # . # . . . . . # . # . . . . . . . #
# . # # # . # # # # # # # . # # # # # # # . # . # . # . # # #
# . . . # . . . # . . . . . # . # . . . . . . . # . # . . . #
# . # . # # # # # # # . # # # . # # # # # . # . # . # # # . #
# . # . . . # . # . . . . . . . . . . . . . # . # . . . # . #
# # # . # . # . # # # . # . # . # . # # # . # # # # # . # # #
# . . . # . . . . . # . # . # . # . # . . . . . . . # . # . #
# # # . # # # . # # # # # . # # # . # # # # # . # # # . # . #
# . . . # . . . . . # . . . . . # . . . # . . . # . . . . . #
# . # . # # # # # # # . # # # . # # # # # # # . # # # # # . #
# . # . . . # . # . # . # . . . . . . . . . # . # . . . . . #
# . # # # # # . # . # . # # # # # # # # # . # # # # # . # # #
# . . O # . # . # . . . . . . . # . # . # . # . . . . . . . #
# . # # # . # . # . # . # # # # # . # . # # # . # # # . # . #
# . . . . . # . . . # . # . . . # . . . # . . . # . # . # . #
# . # # # . # . # # # . # . # # # # # . # . # # # . # . # # #
# . . . # . # . . . # . . . # . . . . . # . . . . . # . . . #
# . # . # # # . # . # # # # # . # . # # # . # # # # # . # # #
# . # . . . . . # . # . . . . . # . . . . . # . . . # . . . #
# # # . # # # . # # # # # . # # # # # # # # # . # . # # # . #
# . . . . . # . . . . . # . # . . . # . . . . . # . . . # . #
# . # . # # # # # . # # # # # . # . # . # # # # # # # . # . #
# . # . . . # . . . . . # . . . # . . . . . # . . . . . . . #
# # # # # # # # # # # # # # # # # # # # # # # # # # # # # # #