# # # # # # # # # # # # # # # # # # # # #
# . . . . . . . . . # . . . . . . . # . #
# . # . # . # # # # # # # # # . # # # . #
# . # . # . # . . . . . # . . . . . . . #
# . # # # . # # # # # O # . # # # # # # #
# . # . . . # . . . . . . . # . . . # . #
# # # # # . # . # # # # # . # # # . # . #
# . . . . . . . # . # . # . . . . . # . #
# . # # # . # # # . # . # # # . # . # . #
# . . . # . . . . . . . # . . . # . . . #
# # # . # # # . # . # # # . # # # # # . #
# . # . # . . . # . # . # . # . . . . . #
# . # . # # # # # . # . # # # . # # # . #
# . . . # . . . . . # . . . . . # . # . #
# # # . # # # # # . # # # . # . # . # # #
# . . . . . # . # . . . # . # . . . . . #
# . # # # . # . # # # . # # # # # # # # #
# . . . # . # . . . . . . . . . . . . . #
# . # # # . # # # # # # # . # . # # # . #
# . . . # . . . . . # . # . # . . . # . #
# # # # # # # # # # # # # # # # # # # # #