# # # # # # # # # # # # # # # # # # # # #
# O . . # . . . # . . . . . # . . . . . #
# . # # # . # # # . # # # . # # # # # . #
# . # . # . . . # . # . . . . . # . . . #
# . # . # # # . # # # # # . # # # # # . #
# . . . # . # . . . . . # . . . # . # . #
# . # # # . # . # . # . # . # # # . # . #
# . . . . . . . # . # . . . # . # . # . #
# . # # # # # . # . # # # # # . # . # . #
# . # . . . . . # . . . # . # . # . . . #
# . # # # # # . # # # . # . # . # . # # #
# . . . # . . . # . . . # . . . . . . . #
# # # # # . # # # # # . # # # # # . # . #
# . . . # . . . . . # . . . . . . . # . #
# # # . # . # . # # # . # # # # # . # . #
# . . . . . # . # . . . # . . . . . # . #
# # # # # # # # # # # # # # # # # # # # #