# # # # # # # # # # # # # # # # # # # # # # # # # # # # # # #
# # . . # . # . # . # # # . # # # # # # # . # . # # # # # . #
# . # . . . . . # . . . # . . . . . # . . . . . . . . . # . #
# # # # # # # . # . # # # # # # # . # # # . # . # # # # # . #
# . . . . . . . # . . . . . # . . . # . # . # . . . . . # . #
# # # . # # # # # . # # # # # . # # # . # . # . # . # . # # #
# . . . # . # . # . # . # . . . # . # . # . # . # . # . . . #
# . # # # . # . # . # . # # # . # . # . # . # # # # # . # . #
# . . . . . . . # . # . . . # . . . . . # . . . . . # . # . #
# # # . # . # . # . # . # # # . # # # . # . # # # # # # # . #
# . . . # . # . # . # . . . . . . . # . # . # . . . . . # . #
# # # . # # # # # # # # # # # . # # # . # # # # # . # . # . #
# . # . . . . . . . . . # . # . # . . . . . . . . . # . # . #
# . # # # . # . # . # # # . # # # # . # # . # . # # # . # # #
# . # . # . # . # . . . . . . O . . # . . . # . # . . . # . #
# . # . # . # # # # # # # . # . # . # # # . # . # # # # # . #
# . # . . . . . . . # . . . # . # . # . # . # . . . . . . . #
# . # # # # # # # # # # # . # . # # # . # # # # # . # # # . #
# . . . . . # . . . # . . . # . # . # . . . . . . . # . . . #
# . # . # . # . # # # . # # # # # . # # # . # . # # # . # . #
# . # . # . . . # . . . # . # . . . # . . . # . . . # . # . #
# . # # # . # . # # # . # . # # # . # # # # # . # # # # # . #
# . . . # . # . . . . . . . . . . . . . # . . . # . . . # . #
# . # # # # # # # # # . # # # # # . # . # # # # # . # . # . #
# . . . . . . . # . . . . . # . # . # . . . # . . . # . . . #
# . # # # . # . # # # . # # # . # . # . # . # . # . # . # . #
# . . . # . # . . . # . . . . . # . # . # . # . # . # . # . #
# # # # # # # # # # # # # # # # # # # # # # # # # # # # # # #