# # # # # #
# . # . . #
# # . # . #
# O # # . #
# # # # # #